border_size=1
usage=map

Gs^Fms      , Gs^Fms      , Gs^Fms      , Gs^Fms      , Gs^Fms      , Gs^Fms      , Gs^Fms      , Gs^Fms      , Gs^Fms      , Gs^Fms      , Gs^Fms      , Gs^Fms      , Gs^Fms      , Gs^Fms      , Gs^Fms      , Gs          , Gs          , Rp          , Gs          , Gs          , Gs          , Gs^Fms      , Gs^Fms      , Gs^Fms      , Gs^Fms      , Gs          , Gs          , Gs^Fds      , Gs^Fds      , Gs^Fds      , Gs^Fds      , Gs^Fds      , Gs^Fds      , Gs^Fds      , Gs^Fds      , Ww          , Hh          , Hh          , Hh          , Hh          
Gs^Fms      , Gs^Fms      , Gs^Fms      , Gs^Fms      , Gs^Vh       , Gs^Fms      , Gs^Fms      , Gs^Fms      , Gs^Fms      , Gs^Fms      , Gs          , Gs^Fms      , Gs          , Gs^Fms      , Gs^Fms      , Gs          , Gs          , Rp          , Rp          , Gs          , Gs          , Gs^Fms      , Gs          , Gs^Fms      , Gs^Fms      , Gs^Fms      , Gs          , Gs^Fds      , Gs          , Gs^Fds      , Re^Gvs      , Gs^Fds      , Gs^Fds      , Gs^Fds      , Gs^Fds      , Ww          , Gs^Fds      , Hh          , Hh          , Hh          
Ww          , Gs          , Ww          , Gs^Fms      , Gs^Fms      , Gs^Fms      , Gs^Fms      , Gs^Fms      , Gs^Fms      , Gs          , Chr         , Gs          , Gs          , Gs          , Gs          , Gs          , Gs          , Gs          , Rp          , Gs          , Gs          , Gs          , Gs          , Gs          , Gs          , Gs          , Gs          , Gs          , Re^Gvs      , Re^Gvs      , Re^Gvs      , Re^Gvs      , Gs          , Gs^Fds      , Gs          , Ww          , Gs^Fds      , Gs^Vh       , Hh          , Hh          
Ww          , Ww          , Gg          , Ww          , Gs          , Gs^Fms      , Gs^Vh       , Gs^Fms      , Gs^Fms      , Chr         , Chr         , Gs          , Gs          , Gs          , Gs          , Gs          , Gs          , Gs          , Gs          , Rp          , Gs          , Gs          , Gs          , Gs          , Gs          , Gs          , Rp          , Re^Gvs      , Re^Gvs      , Re^Gvs      , Gs          , Gs          , Gs          , Gs^Fds      , Gs          , Ww          , Wwf         , Re          , Gs^Fds      , Hh^Fds      
Ww          , Ww          , Gg          , Ww          , Gg          , Gs^Fms      , Gs          , Gs          , Chr         , 2 Khr       , Chr         , Gs          , Gg          , Gs          , Gs          , Gs          , Gs          , Gs          , Gs          , Rp          , Rp          , Gs          , Rp          , Gs          , Rp          , Rp          , Gs^Vh       , Rp          , Rp          , Gs          , Re          , Gs          , Re          , Re          , Re          , Re          , Ww          , Gs^Fds      , Gs^Fds      , Gs^Fds      
Ww          , Ww          , Gg          , Ww          , Ww          , Gs^Fms      , Gg          , Gg          , Chw         , Chr         , Gs          , Gs          , Gs          , Gg          , Gg          , Gs          , Gg          , Gg          , Gs          , Gs          , Gs          , Rp          , Gs          , Rp          , Gs          , Gs          , Gs          , Gs          , Rp          , Re          , Gs          , Re          , Gs          , Gs          , Gs          , Gs^Fds      , Ww          , Gs^Fds      , Gs^Fds      , Gs^Fds      
Ww          , Ww          , Gg          , Gg          , Ww          , Ww          , Ww          , Ww          , Ww          , Gs          , Gs          , Gs          , Gg          , Gg          , Gs          , Gs          , Gs          , Gs          , Gg          , Gs          , Gs          , Gs          , Gs          , Gs          , Gs          , Gg          , Gs          , Gs          , Rp          , Gs          , Gs          , Gs          , Gs          , Gs          , Gs          , Ww          , Gs^Fds      , Gs^Fds      , Re          , Gs^Fds      
Gg          , Ww          , Ww          , Ww          , Gg          , Gs^Fms      , Gs^Fms      , Gg          , Gg          , Ww          , Ww          , Ww          , Ww          , Gg          , Gs          , Gs          , Gs          , Gs          , Gs          , Gs^Fp       , Gs^Fp       , Gs          , Gs          , Gg          , Gg          , Gg          , Rp          , Rp          , Gs          , Gs          , Gs          , Gs          , Re^Gvs      , Gs          , Gs^Fds      , Ww          , Ww          , Gs^Fds      , Gs^Fds      , Gs^Fds      
Gg          , Gg          , Ww          , Gg          , Gg          , Gg^Vh       , Gs^Fms      , Gg          , Gg          , Gg          , Gg          , Gg          , Gg          , Ww^Bw/      , Ww          , Gg          , Gg          , Gg          , Gs          , Gs^Fp       , Gs^Fp       , Gs          , Gs^Fp       , Gs          , Gs          , Rp          , Gs          , Rp          , Rp          , Gs          , Re^Gvs      , Re^Gvs      , Re^Gvs      , Re^Gvs      , Re^Gvs      , Gs^Fds      , Gs^Fds      , Ww          , Gs^Fds      , Gs^Fds      
Ww          , Ww          , Wo          , Ww          , Ww          , Gg          , Gs^Fms      , Gs^Fms      , Gg          , Gs^Fms      , Gs^Fms      , Gg          , Gg          , Gg          , Ww          , Gg          , Gs          , Gs          , Gg          , Gs          , Gs          , Gs^Fp       , Gs          , Gs          , Gg          , Rp          , Gs          , Gs          , Rp          , Gs          , Gs          , Re^Gvs      , Re^Gvs      , Re^Gvs      , Gs          , Gs^Fds      , Gg^Vh       , Ww          , Ww          , Ww          
Ww          , Ww          , Wo          , Wo          , Ww          , Gg          , Gs^Fms      , Gs^Fms      , Gs^Fms      , Gg          , Gs^Fms      , Gg          , Gg          , Gg          , Wwf         , Gg          , Gg          , Gg          , Gg          , Gg          , Gs          , Gs          , Gg          , Gs          , Gg          , Rp          , Gg          , Gg          , Rp          , Gg          , Gg          , Gg          , Gg          , Gg          , Gg          , Gg          , Ww          , Ww          , Gg          , Gg          
Ww          , Ww          , Ww          , Ww          , Gg          , Gg          , Gs^Fms      , Gg          , Gg          , Gs^Fms      , Gs^Fms      , Gg          , Gg          , Gg          , Gg          , Ww          , Ww          , Gg          , Gs          , Gg          , Gg          , Gs          , Gg          , Gg          , Gg^Vh       , Rp          , Gg          , Gg          , Gg          , Rp          , Gg          , Gg^Vh       , Ww          , Ww          , Ww          , Ww          , Gg          , Gg          , Gg          , Gg          
Ww          , Ww          , Ww          , Ww          , Gg          , Gg^Vh       , Gs^Fms      , Gs^Fms      , Gs^Fms      , Gs^Fms      , Gs^Fms      , Gg          , Gg          , Gg          , Gs^Fms      , Gg          , Gg          , Ww          , Ww^Bw|      , Gg          , Ww          , Gg          , Ww          , Gg          , Ww          , Ww^Bw|      , Ww          , Gg          , Ww          , Rp          , Ww^Bw\      , Ww          , Gg          , Ww          , Gg          , Gg          , Gg          , Gg          , Gs^Fds      , Gs^Fds      
Gg          , Gg          , Ww          , Gg          , Gg          , Gg          , Gs^Fms      , Gg          , Gs^Fms      , Gs^Vh       , Gs^Fms      , Gg          , Gs^Fms      , Gg          , Gg          , Gg          , Gs^Fms      , Gg          , Gg          , Ww          , Gg          , Ww          , Gg          , Ww          , Gg          , Rp          , Gg          , Ww          , Gg          , Ww          , Gg          , Rp          , Rp          , Gg          , Gg          , Gg^Vh       , Gg          , Gg          , Gs^Fds      , Gs^Fds      
Gg          , Gg          , Gg          , Ww          , Gg          , Gs^Fms      , Gs^Fms      , Gg          , Gs^Fms      , Gs^Fms      , Gs^Fms      , Gg          , Gg          , Gg          , Gg          , Gs^Fms      , Gs^Fms      , Gg          , Gg          , Gg          , Gg          , Gg          , Gg          , Gg          , Gg          , Rp          , Rp          , Gg          , Gs^Fdw      , Gg          , Gg          , Gg          , Gg          , Rp          , Rp          , Rp          , Rp          , Gs^Fds      , Gs^Fds      , Gs^Fds      
Gg          , Gg          , Gg          , Ww          , Gg          , Gg          , Gg          , Gs^Fms      , Gg          , Gs^Fms      , Gg          , Gg          , Gs^Fms      , Gs^Fms      , Gs^Fms      , Gg          , Gg          , Gg          , Gg          , Gs^Fms      , Gg          , Gg          , Gg          , Gg          , Gg          , Gg          , Rp          , Gg          , Gs^Fdw      , Gg          , Gg          , Gg          , Gg          , Gg          , Gg          , Gg          , Rp          , Gs^Fds      , Gg          , Gg          
Gg          , Gg          , Ww          , Ww          , Gg          , Gg          , Gg          , Gs^Fms      , Gs^Fms      , Gs^Fms      , Gs^Fms      , Gg          , Gg          , Gs^Fms      , Gg          , Gs^Fms      , Gg          , Gg          , Hh          , Gg          , Gs^Fms      , Gg          , Hh          , Gg          , Gg          , Gg          , Rp          , Gg          , Gg          , Gg          , Gg          , Gg          , Gg          , Gs^Fds      , Gg          , Gg          , Rp          , Gg          , Rp          , Rp          
Gg          , Gg          , Ww^Bw/      , Gg          , Gg          , Gg          , Gg          , Gs^Fms      , Gs^Fms      , Gg          , Gs^Fms      , Gg          , Gg          , Gg          , Gg          , Gs^Fms      , Gg          , Gs^Fms      , Gg          , Gg          , Gg          , Gg          , Hh          , Hh          , Gg          , Gg          , Rp          , Gg          , Gg          , Gg          , Gg^Efm      , Gg          , Gg^Efm      , Gg          , Gg          , Gg          , Gg          , Rp          , Gg          , Gg          
Gg          , Gg          , Gg          , Ww          , Gg          , Gg          , Gg          , Gg          , Gg          , Gg          , Gs^Fms      , Gg          , Gs^Fms      , Gs^Fms      , Gs^Fms      , Gg          , Gg          , Gs^Fms      , Gg          , Gg          , Gs^Fms      , Gg          , Gg          , Gg          , Gg          , Gg          , Gg          , Rp          , Gg          , Gg^Efm      , Gg^Efm      , Gg          , Gg          , Gg          , Gg          , Gg^Vh       , Gg          , Gg          , Gg          , Gg          
Hh          , Gg          , Gg          , Ww          , Gg          , Gg          , Gg          , Gg          , Gg          , Gg          , Gg          , Gg          , Gg          , Gg          , Gg          , Gg          , Gs^Fms      , Gg          , Gg          , Gs^Fms      , Gg          , Gg          , Hh          , Gg          , Gg          , Hh          , Gg^Vh       , Rp          , Gg          , Gg          , Gg          , Gg          , Ce          , Ce          , Gg          , Gg          , Gg^Efm      , Gg^Efm      , Gg          , Gg          
Gg          , Hh          , Ww          , Ww          , Hh          , Gg          , Gg          , Gg          , Gg          , Gg          , Gg          , Gs^Fms      , Gg          , Gs^Fms      , Gs^Fms      , Gg          , Hh          , Gg          , Gg          , Hh          , Gg          , Hh          , Gg          , Gg          , Gg          , Gg          , Gg          , Rp          , Gg          , Gg          , Gg          , Ce          , 1 Ke        , Gg          , Ce          , Gg          , Gg          , Gg^Efm      , Gg          , Gg          
Hh          , Gg          , Hh          , Ww          , Hh          , Gg          , Gg          , Gg          , Gg          , Gg          , Gg          , Gg          , Gg          , Gg          , Gg          , Gg          , Hh          , Gg          , Gs^Fms      , Gg          , Gg          , Gg          , Hh          , Gg          , Gg          , Gg          , Gg          , Rp          , Rp          , Rp          , Rp          , Ce          , Ce          , Ce          , Ce          , Gg          , Gg          , Gg          , Gg          , Gg          
Hh          , Hh          , Gg          , Ww          , Gg          , Gg          , Hh          , Gg          , Gg          , Gg          , Gg          , Gg          , Gg          , Gg          , Gg          , Gg          , Gs^Fms      , Gg          , Gg          , Gg          , Gg          , Hh          , Gg          , Gg          , Hh          , Gg          , Gg          , Gg          , Gg^Efm      , Gg          , Rp          , Gg          , Gg          , Ce          , Gg          , Gg          , Gg^Vh       , Gg          , Gs^Fms      , Gg          
Hh          , Hh          , Ww          , Ww          , Hh          , Gg          , Gg          , Gg          , Hh          , Hh          , Gg          , Gg          , Gg          , Gs^Fms      , Hh          , Hh          , Gg          , Gg          , Hh          , Gg          , Hh          , Hh          , Gg          , Gg          , Gg          , Hh          , Hh          , Gg          , Gg          , Gg          , Gg          , Rp          , Rp          , Gg          , Gg^Efm      , Gg          , Gg          , Gg          , Gs^Fms      , Gs^Fms      
Mm          , Mm          , Ww          , Mm          , Mm          , Hh          , Gg          , Gg          , Hh          , Hh          , Gg          , Gg          , Gg          , Gg          , Gg          , Hh          , Gg          , Hh          , Gg          , Gg          , Hh          , Gg          , Gg          , Gg          , Hh          , Gg^Vh       , Hh          , Gg          , Gg          , Gg^Efm      , Gg          , Gg^Efm      , Gg          , Rp          , Rp          , Gg          , Gg          , Gs^Fms      , Gs^Fms      , Gs^Fms      
Mm          , Mm          , Mm          , Ww          , Ww          , Mm          , Hh          , Hh          , Mm          , Mm          , Hh          , Gg          , Hh          , Gg          , Gg          , Gg          , Gg          , Hh          , Hh          , Gg          , Gg          , Gg          , Hh          , Gg          , Hh          , Gg          , Hh          , Hh          , Hh          , Gg          , Gg          , Gg          , Gg          , Gg          , Rp          , Gg          , Gg          , Gs^Fms      , Gs^Fms      , Gs^Fms      
Mm          , Mm^Xm       , Mm          , Mm          , Ww          , Mm          , Mm          , Hh          , Mm          , Mm          , Mm          , Mm          , Mm          , Hh          , Hh          , Gg          , Gg          , Gg          , Hh          , Gg          , Gg          , Hh          , Gg          , Hh          , Hh          , Gg          , Hh          , Hh          , Hh          , Gg          , Gg          , Gg^Vh       , Gg          , Gg^Efm      , Gg          , Rp          , Rp          , Gg          , Gg          , Gs^Fms      
Mm          , Mm          , Ww          , Ww          , Mm          , Mm          , Mm          , Mm^Xm       , Mm^Xm       , Mm          , Mm          , Mm          , Mm          , Mm          , Mm          , Gg          , Gg          , Hh          , Gg          , Gg          , Hh          , Hh          , Gg          , Gg          , Hh          , Hh          , Hh          , Hh          , Hh          , Hh          , Hh          , Gg          , Gg          , Gg          , Gg          , Gg          , Gg          , Rp          , Gg          , Gg          
Ww          , Ww          , Wo          , Ww          , Ww          , Mm          , Mm          , Mm^Xm       , Mm^Xm       , Mm^Xm       , Mm^Xm       , Mm          , Mm^Xm       , Mm          , Mm          , Gg          , Mm          , Hh          , Hh          , Hh          , Hh          , Hh          , Hh          , Hh          , Hh          , Hh          , Hh          , Hh          , Mm          , Hh          , Mm          , Mm          , Hh          , Hh          , Gs^Fms      , Gg          , Gg          , Rp          , Gg          , Gg          
Ww          , Ww          , Wo          , Wo          , Ww          , Mm          , Mm          , Mm^Xm       , Mm^Xm       , Mm^Xm       , Mm^Xm       , Mm^Xm       , Mm^Xm       , Mm^Xm       , Mm^Xm       , Mm          , Mm          , Mm          , Mm          , Mm          , Mm          , Mm          , Mm          , Mm          , Mm          , Mm          , Mm          , Mm          , Mm^Xm       , Mm^Xm       , Mm^Xm       , Mm          , Mm^Xm       , Hh          , Hh^Fms      , Gs^Fms      , Hh          , Rp          , Rp          , Gg          
Ww          , Ww          , Ww          , Wo          , Wo          , Ww          , Ww          , Mm^Xm       , Mm          , Mm^Xm       , Mm          , Mm^Xm       , Mm^Xm       , Mm^Xm       , Mm^Xm       , Mm^Xm       , Mm^Xm       , Mm^Xm       , Mm^Xm       , Mm^Xm       , Mm^Xm       , Mm          , Mm          , Mm          , Mm          , Mm^Xm       , Mm^Xm       , Mm^Xm       , Mm^Xm       , Mm^Xm       , Mm^Xm       , Mm^Xm       , Mm^Xm       , Hh          , Hh          , Hh^Fms      , Hh^Fms      , Gs^Fms      , Rp          , Gg          
Ww          , Ww          , Ww          , Wo          , Wo          , Wo          , Ww          , Ww          , Mm          , Mm          , Mm          , Mm          , Mm          , Mm          , Mm          , Mm          , Mm          , Mm          , Mm          , Mm          , Mm          , Mm          , Mm          , Mm          , Mm          , Mm          , Mm          , Mm          , Mm          , Mm          , Mm          , Mm          , Mm          , Hh          , Hh          , Hh^Fms      , Gs^Fms      , Gs^Fms      , Rp          , Gg          
