border_size=1
usage=map

Gll^Fp      , Gll^Fp      , Gll^Fp      , Gll^Fp      , Gll^Fp      , Gll^Fp      , Gll^Fp      , Gs          , Gs          , Re          , Gs          , Gs          , Gs          , Gs          , Gs          , Gs^Fms      , Gs^Fms      , Ww          , Gs^Fms      , Gs^Fms      , Gs^Fms      
Gll^Fp      , Gll^Fp      , Gll^Fp      , Gll^Fp      , Gs          , Gll^Fp      , Gll^Fp      , Gs          , Re          , Re          , Gs          , Gs          , Gs          , Gs          , Gs          , Gs^Fms      , Gs^Fms      , Ww          , Gs^Fms      , Gs^Fms      , Gs^Fms      
Gll^Fp      , Gll^Fp      , Gll^Fp      , Gll^Fp      , Gll^Fp      , Gll^Fp      , Re          , Re          , Gs          , Re          , Gs          , Gs          , Gs          , Gs          , Gs          , Gs^Fms      , Gs^Fms      , Ww          , Ww          , Gs^Fms      , Ww          
Gll^Fp      , Gll^Fp      , Re          , Re          , Re          , Re          , Gll^Fp      , Gll^Fp      , Gll^Fp      , Re          , Gll^Fp      , Gs          , Gs^Fms      , Gs^Fms      , Gs^Fms      , Gs^Fms      , Gll^Fds     , Gll^Fds     , Ww          , Ww          , Gs^Fds      
Gll^Fp      , Re          , Gll^Fp      , Gll^Fp      , Gll^Fp      , Gll^Fp      , Gll^Fp      , Gll^Fp      , Gll^Fp      , Re          , Gll^Fp      , Gll^Fp      , Gs          , Gs          , Gs^Fms      , Gs^Fms      , Gll^Fds     , Gg^Vh       , Ss          , Gs^Fds      , Ss          
Gll^Fp      , Re          , Gll^Fp      , Gll^Fp      , Gll^Fp      , Gll^Fp      , Gll^Fp      , Gll^Fp      , Gll^Fp      , Re          , Gll^Fp      , Gs          , Gs^Fms      , Gs          , Gs^Fms      , Gs^Fms      , Gll^Fds     , Ss          , Ss          , Ss          , Gll^Fds     
Re          , Re          , Gll^Fp      , Gll^Fp      , Gll^Fp      , Gll^Fp      , Gll^Fp      , Gll^Fp      , Gll^Fp      , Re          , Gll^Fp      , Gs          , Gs          , Gll^Fds     , Gll^Fds     , Gll^Fds     , Ss          , Ss          , Ss          , Gll^Fds     , Gll^Fds     
Hh          , Hh^Fp       , Hh^Fp       , Hh^Fp       , Hh^Fp       , Gll^Fp      , Gll^Fp      , Gll^Fp      , Gll^Fp      , Re          , Re          , Gll^Fp      , Re          , Gll^Fds     , Gll^Fds     , Gll^Fds     , Ss          , Ss          , Ss          , Ss          , Ss          
Mm          , Hh          , Hh          , Hh          , Hh          , Gs          , Gll^Fp      , Gll^Fp      , Gll^Fp      , Gs          , Gll^Fp      , Re          , Re          , Re          , Gll^Fms     , Gll^Fds     , Gll^Fds     , Gs          , Ss          , Ss          , Ss          
Mm^Xm       , Mm          , Mm          , Hh          , Hh          , Gs          , Gs          , Gll^Fp      , Gll^Fp      , Gs          , Gs          , Gll^Fms     , Gll^Fms     , Re          , Gll^Fms     , Gs          , Gll^Fms     , Gs          , Ss          , Ss          , Ss          
Mm^Xm       , Mm^Xm       , Mm^Xm       , Mm          , Mm          , Hh          , Hh^Fp       , Gll^Fp      , Gll^Fp      , Gll^Fp      , Gs          , Gs          , Re          , Re          , Gll^Fms     , Gll^Fms     , Ss          , Ss          , Ss          , Ss          , Ss          
Mm          , Mm^Xm       , Mm^Xm       , Mm          , Mm          , Hh          , Hh          , Hh^Fp       , Gll^Fp      , Gll^Fp      , Gll^Fp      , Re          , Gll^Fp      , Re          , Gll^Fms     , Gll^Fms     , Gll^Fms     , Ss          , Ss          , Ss          , Ss          
Mm          , Mm          , Mm          , Hh          , Hh          , Hh          , Hh^Fp       , Gll^Fp      , Gll^Fp      , Gll^Fp      , Gs^Vh       , Gll^Fp      , Re          , Re          , Gs^Fp       , Gll^Fms     , Gll^Fms     , Gs^Fds      , Gs^Fds      , Ss          , Gs^Fds      
Hh          , Mm          , Hh          , Hh^Fp       , Gll^Fp      , Hh^Fp       , Hh^Fp       , Gll^Fp      , Gll^Fp      , Gll^Fp      , Gs          , Gll^Fp      , Re          , Re          , Re          , Re          , Gll^Fms     , Gs^Fds      , Gs^Fds      , Gs^Fds      , Gs^Fds      
Ww          , Hh          , Ww          , Ww          , Ww          , Gll^Fp      , Gll^Fp      , Gll^Fp      , Re          , Gll^Fp      , Re          , Re          , Gs          , Gs^Fp       , Re          , Gs^Fp       , Gll^Fms     , Gll^Fms     , Gll^Fms     , Gs^Fds      , Gs^Fds      
Ww          , Ww          , Ww          , Ww          , Gs          , Gll^Fp      , Gll^Fp      , Re          , Gll^Fp      , Gs          , Re          , Gs^Fp       , Gs          , Re          , Gs^Fp       , Gs^Fp       , Gs          , Gll^Fms     , Gll^Fms     , Gll^Fms     , Gll^Fms     
Ww          , Ww          , Ww          , Gs          , Gs^Fms      , Gll^Fp      , Gll^Fp      , Gll^Fp      , Gll^Fp      , Gs          , Re          , Re          , Gs^Fp       , Gs^Fp       , Re          , Gs^Fp       , Gs^Fp       , Gs^Fp       , Gs^Fp       , Gll^Fms     , Gll^Fms     
Gs^Fms      , Ww          , Gs^Ve       , Gs^Fms      , Gs^Fms      , Gll^Fp      , Gll^Fp      , Gll^Fp      , Gll^Fp      , Re          , Re          , Gs          , Gs^Fp       , Gs^Fp       , Gs^Fp       , Gs^Fp       , Gs^Fp       , Gs^Fp       , Gs          , Hh^Fms      , Hh^Fms      
Gs^Fms      , Gs^Fms      , Gs^Fms      , Gs^Fms      , Gs^Fms      , Gll^Fp      , Gs^Fms      , Gs^Fms      , Gs          , Gs          , Re          , Gs          , Gs^Vh       , Gs^Fp       , Gs^Fp       , Gs^Fp       , Gs^Fp       , Gs^Fp       , Hh          , Hh^Fms      , Hh^Fms      
Gs^Fms      , Gs^Fms      , Gs^Fms      , Gs^Fms      , Gs          , Gs^Fms      , Gs^Fms      , Gs^Fms      , Re          , Re          , Re          , Gs^Fp       , Gg          , Gs^Fp       , Gs^Fms      , Gs^Fms      , Hh          , Hh          , Mm          , Mm          , Mm^Xm       
Gs^Fms      , Gs^Fms      , Gs^Fms      , Gs          , Gs^Fms      , Gs^Fms      , Re          , Gs^Fms      , Gg          , Gs^Fms      , Gg          , Re          , Re          , Gg          , Re          , Gs^Fms      , Hh          , Mm          , Mm^Xm       , Mm^Xm       , Mm^Xm       
Gs^Fms      , Gs^Fms      , Gg^Fet      , Gs^Fms      , Gs^Fms      , Gs^Fms      , Re          , Gs^Fms      , Gs^Fms      , Gs^Fms      , Gg^Ve       , Gg          , Re          , Re          , Gs^Fms      , Hh          , Mm          , Mm          , Mm          , Mm^Xm       , Mm          
Gs^Fms      , Gs^Fms      , Gs^Fms      , Gs^Fms      , Gs^Fms      , Gs^Fms      , Gs          , Gs^Fms      , Gs^Fms      , Gs^Fms      , Gs^Fms      , Gs^Fms      , Re          , Gg          , Gs^Fms      , Re          , Gs^Fds      , Mm          , Mm          , Mm          , Re          
Gs^Fms      , Gs^Fms      , Gs^Fms      , Gs^Fms      , Gs^Vh       , 2 Kh        , Ch          , Gs^Fms      , Gs^Fms      , Gs^Fms      , Gs^Fms      , Gg          , Rd          , Gg          , Gs^Fms      , Gs^Fds      , Gs          , Re          , Re          , Re          , Gs^Fds      
Gs^Fms      , Gs^Fms      , Gs^Fms      , Gs          , Gg          , Gs^Fms      , Gs^Fms      , Gs^Fms      , Gs^Fms      , Gs^Fms      , Rd          , Rd          , Gs^Fms      , Gg          , Hh          , Gg          , Hh^Fds      , Hh^Fds      , Hh^Fds      , Gs^Fds      , Gs^Fds      
Gs^Fms      , Gs^Fms      , Gs^Fms      , Gs^Fms      , Gs^Fms      , Gs^Fms      , Gg          , Gs^Fms      , Gs^Fms      , Gs^Fms      , Gg          , Rd          , Rd          , Hh          , Gs^Fms      , Hh          , Hh          , Hh          , Hh          , Gs          , Gs^Fds      
Ww          , Wwf         , Wwf         , Gg          , Ww          , Ww          , Gs^Fms      , Gs^Fms      , Gs^Fms      , Gg          , Gs^Fms      , Re          , Gg          , Gg          , Gs^Fds      , Hh^Fds      , Hh^Fds      , Hh          , Hh          , Hh^Fds      , Gs^Fds      
Re          , Re          , Gs^Fms      , Ww          , Ww          , Ww          , Ww          , Gg          , Ww          , Ww          , Ww          , Re          , Wwf         , Gg          , Ww          , Gs^Fds      , Ww          , Ww          , Ww          , Ww          , Ww          
Hh          , Rd          , Re          , Ww          , Gs^Fms      , Ww          , Gs^Fms      , Ww          , Gs^Fms      , Gs^Fms      , Gs^Fms      , Wwf         , Gg          , Ww          , Gs^Fds      , Ww          , Gs^Fds      , Gs^Fds      , Ww          , Ww          , Gg          
Hh^Fms      , Hh          , Re          , Hh          , Hh          , Gs^Fms      , Gs^Fms      , Gs^Fms      , Gs^Fms      , Gs^Ve       , Rd          , Rd          , Gs^Fms      , Gg          , Gs^Fds      , Gs^Fds      , Gs^Fms      , Ww          , Gs^Fds      , Ww          , Gg          
Hh^Fms      , Hh^Fms      , Hh^Fms      , Hh          , Gs^Fms      , Gg          , Gs^Fms      , Gs^Fms      , Gs^Fms      , Gs^Fms      , Gg          , Rd          , Rd          , Gg^Ve       , Gg          , Gs^Fms      , Gs^Fms      , Gs^Fds      , Gs^Fms      , Gg          , Gg          
Hh          , Hh          , Gs^Fms      , Gg          , Gs^Fms      , Gs^Fms      , Gs^Fms      , Gg          , Gg          , Gs^Fms      , Gg^Vh       , Rd          , Gs^Fms      , Gs^Fms      , Gs^Fms      , Gs^Fms      , Gg          , Gs^Fms      , Gs^Fms      , Gs^Fms      , Gs^Fms      
Gs^Fms      , Gs^Fms      , Gs^Fms      , Gs^Fms      , Re          , Re          , Gs^Fms      , Gg          , Gg          , Gs^Fms      , Gs^Fms      , Rd          , Gs^Fms      , Gs^Fms      , Gg          , Gs^Fms      , Gg          , Gg          , Gs^Fms      , Gs^Fms      , Gs^Fms      
Re          , Gs^Fms      , Gg          , Re          , Gg          , Re          , Gg          , Gg          , Gs^Fms      , Gs^Fms      , Gs^Fms      , Rd          , Gs^Fms      , Gs^Vh       , Gs^Fms      , Gg          , Gs^Fms      , Gs^Fms      , Gs^Fms      , Gs^Fms      , Gs^Fms      
Gs^Fms      , Re          , Re          , Gg          , Gg          , Gs^Fms      , Chr         , Gs^Fms      , Gg          , Gg          , Gg          , Rd          , Gg          , Gs^Fms      , Gs^Fms      , Gs^Fms      , Hh          , Hh          , Hh^Fms      , Hh^Fms      , Gs^Fms      
Gs^Fms      , Gs^Fms      , Gs^Fms      , Gs^Fms      , Gs^Fms      , Chr         , Gs^Fms      , Gg          , Gg          , Gg^Fms      , Rd          , Rd          , Re          , Gg          , Gg          , Gs^Fms      , Gs^Fms      , Hh          , Gs^Fms      , Hh^Fms      , Gs^Fms      
Gs^Fms      , Gs^Fms      , Gs^Fms      , Re          , Gs^Fms      , Chr         , Gg          , Chr         , Gg          , Gg^Fms      , Rd          , Gg^Fms      , Gg          , Re          , Re          , Gs^Fms      , Gs^Fms      , Gs^Fms      , Gs^Fms      , Gs^Vh       , Gs          
Gs^Fms      , Gs^Fms      , Gg          , Gg          , Gg          , Gg          , Gg          , Gg^Fms      , Re          , Rd          , Gs^Fms      , Gg          , Gs^Fms      , Gs^Fms      , Gs^Fms      , Re          , Re          , Gs^Fms      , Gs^Fms      , Gs^Fms      , Gs^Fms      
Gs^Fms      , Gs^Fms      , Gs^Fms      , Gs^Ve       , Gs^Fms      , Gg          , Rd          , Rd          , Gg          , Gs^Fms      , Gs^Fms      , Gg          , Gs^Fms      , Gs^Ve       , Gs^Fms      , Gs^Fms      , Re          , Gg          , Gs^Fms      , Gs^Fms      , Gs^Fms      
Gs^Fms      , Gs^Fms      , Gs^Fms      , Gs^Fms      , Gs^Fms      , Gs^Fms      , Rd          , Gg          , Gg          , Gs^Fms      , Gg          , Gs^Fms      , Gg          , Gs^Fms      , Gg          , Gs^Fms      , Re          , Gs^Fms      , Gs^Fms      , Gs^Fms      , Gs^Fms      
Gs^Fms      , Gs^Fms      , Gs^Fms      , Gg          , Gg          , Re          , Rd          , Gg          , Gg^Vh       , Gg          , Gs^Fms      , Gs^Fms      , Gs^Fms      , Gg          , Gg          , Gg          , Gs^Fms      , Re          , Re          , Re          , Re          
Gs^Fms      , Gs^Fms      , Gs^Fms      , Gs^Fms      , Gg          , Gg          , Gg^Fms      , Rd          , Rd          , Gs^Fms      , Gs^Fms      , Gg          , Gs^Fms      , Gg          , Gs^Fms      , Gg          , Gs^Fms      , Gs^Fms      , Gs^Fms      , Gg          , Gg          
Gs^Fms      , Gs^Fms      , Gs^Fms      , Gs^Fms      , Gs^Fms      , Gg          , Rd          , Rd          , Gs^Fms      , Gg          , Gs^Fms      , Gs^Fms      , Gg          , Gg          , Gg          , Gg          , Gg          , Gs^Fms      , Gs^Fms      , Gg          , Gs^Fms      
Gg          , Gs^Fms      , Gg          , Gg          , Rd          , Rd          , Gs^Fms      , Gg          , Gs^Fms      , Gg          , Gg          , Gg          , Gs^Fms      , Gs^Fms      , Gs^Fms      , Gg          , Gs^Fms      , Gs^Fms      , Gs^Fms      , Gs^Fms      , Gs^Fms      
Gg          , Gg          , Gg          , Gs^Fms      , Gg          , Rd          , Rd          , Gg          , Gg          , Gg          , Gg          , Gs^Fms      , Re          , Gg          , Gs^Fms      , Gs^Fms      , Gg          , Gg          , Gg          , Gs^Fms      , Gs^Fms      
Gg          , Gg          , Gg          , Gs^Fms      , Gg          , Gs^Fms      , Gs^Fms      , Rd          , Gs^Fms      , Gs^Fms      , Gs^Fms      , Re          , Gs^Fms      , Gs^Fms      , Gg          , Gs^Fms      , Gs^Fms      , Gg          , Gs^Fms      , Gs^Fms      , Gs^Fms      
Gs^Fms      , Gs^Fms      , Gs^Fms      , Gs^Fms      , Gg          , Gg          , Gs^Fms      , Rd          , Gs^Fms      , Gg          , Gg          , Gs^Fms      , Gs^Vh       , Gg          , Gg          , Gs^Fms      , Gg          , Gs^Fms      , Gg          , Gg          , Gs^Fms      
Gs^Fms      , Gs^Fms      , Gs^Fms      , Gs^Vh       , Gs^Fms      , Gs^Fms      , Rd          , Rd          , Rd          , Rd          , Rd          , Gs^Fms      , Gs^Fms      , Gs^Fms      , Gs^Fms      , Gs^Fms      , Rd          , Gs^Fms      , Rd          , Gs^Fms      , Gs^Fms      
Gg          , Gs^Fms      , Gg          , Gs^Fms      , Rd          , Rd          , Gg          , Gg          , Gg          , Gg          , Gg          , Gg          , Rd          , Gg          , Rd          , Gs^Fms      , Gs^Fms      , Rd          , Gs^Fms      , Rd          , Rd          
Rd          , Rd          , Rd          , Rd          , Gg          , Gg          , Gg          , Gg          , Ce          , Ce          , Ce          , Gg          , Gg          , Rd          , Gg          , Gg          , Gg          , Gs^Fms      , Gg          , Gg          , Gg          
Gg          , Gs^Fms      , Gg          , Rd          , Gg          , Gg          , Gg          , Ce          , Ce          , 1 Ke        , Ce          , Ce          , Gg          , Gg          , Gg          , Gg          , Gs^Fds      , Gs^Fds      , Hh          , Hh          , Hh          
Gg          , Gg          , Gg          , Gg          , Gg          , Gg          , Gg          , Gg          , Gg          , Ce          , Gg          , Gg          , Gg          , Gg          , Gg          , Gg          , Gs^Vh       , Hh^Fds      , Hh^Fds      , Mm          , Hh          
Ww          , Ww          , Ww          , Gs^Fds      , Gs^Fds      , Gs^Fds      , Gs^Fds      , Gg          , Gg          , Gg          , Gg          , Gg          , Gg          , Gg          , Gg          , Gs^Fds      , Gs^Fds      , Hh^Fds      , Hh^Fds      , Hh          , Gs^Fds      
Ww          , Ww          , Ww          , Ww          , Gs^Fds      , Gs^Fds      , Gs^Fds      , Gg          , Gg          , Gg          , Gg          , Gg          , Gg          , Gg          , Gg          , Gg          , Gg          , Gs^Fds      , Gs^Fds      , Gs^Fds      , Gs^Fds      
Ww          , Ww          , Ww          , Gs^Fds      , Gs^Fds      , Gs^Fds      , Gs^Fds      , Gg          , Gg          , Gg          , Gg          , Gg          , Gg          , Gg          , Gg          , Gg          , Gg          , Gg          , Gs^Fds      , Gs^Fds      , Gs^Fds      
